R   1920 1080

NO  ./textures/bluestone.xmp
SO ./textures/eagle.xmp
EA  ./textures/bluestone.xmp
WE   ./textures/wall_1.xmp


F   220,  100,0
C 225,30  ,3


        1111111111111111111111111
        1000000000110000000000001
        101100E001110000001000001
        1001000000000000000000001
111111111011000001110000000000001
100000000011000001110111111111111
11110111111111011100000010001
11110111111111011101010010001
11001000000101011100000010001
10000000000000011000000100001
10000000000000001101010010001
1100000111010101111101111000111
11110111 1110101 101111010001
11111111 1111111 111111111111
