R   1920 1080

F   220,  100,0
C 225,30  ,3


  111111
11100101
1010S111
10000001
11111111
