R   1920 1080

NO  /Users/isfernan/42cursus/cub3d/cub3d_prueba_editado/cub3d_fake/textures/bluestone.xpm
SO /Users/isfernan/42cursus/cub3d/cub3d_prueba_editado/cub3d_fake/textures/eagle.xpm
EA  /Users/isfernan/42cursus/cub3d/cub3d_prueba_editado/cub3d_fake/textures/wall_1.xpm
WE   /Users/isfernan/42cursus/cub3d/cub3d_prueba_editado/cub3d_fake/textures/wall_2.xpm


F   220,  100,0
C 225,30  ,3


        1111111111111111111111111
        1002000000110000000002001
        101100W001110000001000001
        1001000000000000000002001
111111111011000001110000000000001
100000000011000001110111111111111
11110111111111011100000010001
11110111111111011101010010001
11001000000101011100000010001
10000020000000011000000100001
10020000000000001101010010001
1100000111010101111101111000111
11110111 1110101 101111010001
11111111 1111111 111111111111
