R   1920 1080

NO  ./textures/bluestone.xpm
SO ./textures/eagle.xpm
EA  ./textures/wall_1.xpm
WE   ./textures/wall_2.xpm


S ./textures/sprite_2.xpm

F   0,  100,40
C 0,1000  ,100

  111111
11110101
1000N111
10000001
11111111
