R   1920 1080

NO  ./textures/bluestone.xpm
SO ./textures/eagle.xpm
EA  ./textures/wall_1.xpm
WE   ./textures/wall_2.xpm


S ./textures/sprite_1.xpm

F   0,  100,40
C 0,30  ,100


        1111111111111111111111111
        1002000000110000000002001
        1011000001110000001000001
        100100000000000000000N001
111111111011000001110000000002001
100000000011000001110111111111111
11110111111111011100000010001
11110111111111011101010010001
11001000000101011100000010001
10000020000000011000000100001
10020000000000001101010010001
1100000111010101111101111000111
11110111 1110101 101111010001
11111111 1111111 111111111111
