R   1920 1080

F   220,  100,0
C 225,30  ,3


  111111
11110101
1000N111
10000001
11111111
